WWWWWWWWWWWWWWWWWWWWWWWWWW
W                        W
W   T    WWWWWWWW    O   W
W                        W
WWWWWW              WWWWWW
W                        W
W                        W
W     WWWW      WWWW     W
W                        W
W                        W
W       WWWWWWWWWW       W
WWWWWWWWWWWWWWWWWWWWWWWWWW
